0, 0,30, 0,  0, 0, 50, 0
0, 0, 10, 0, 40, 0, 0, 30
30, 10, 0, 40, 70, 0, 0, 60
0, 0, 40, 0, 0, 20, 50, 0
0, 40, 70, 0, 0, 60, 0, 30
0, 0, 0, 20, 60, 0, 40, 10
50, 0, 0, 50, 0, 40, 0, 0
0, 30, 60, 0, 30, 10, 0, 0
